S000000000000000000000000000000000000000000000000000000000000000000000000000000000000000000000000000
00000000W00W00W00000000000000000000000000000000000W0000000000000000000W0000000000W000000WW00W0000000
0000W0W00000000000000000W000W00000000000000W0000000W000000000000W000000000000000000W000000W000000000
00000000W00000000W000000000000000W0W000000000000000W00W0W00000WW0000000000W000000W0000W0000000000000
W00000W00000W0000000000W000000W00W0W00000W000000000000000W000W00000000W000000W0000000000000000000000
0000W0W00000000000000000W000000W0000000000000000000000000000000000000000000000000000000W00000W000000
W0000000000000000W00000000000000000000000W0000W0W0000000000000000W00000000000000W000W0W00000W0W0W000
00W0000000000000000000000000000W00000000000000000000000000000000W0000W0W0000000W00000000000000000000
00000000W000000000000000000000W00W0000W00000000000000000000000000000W0000000000W0000W0000000W0000000
00000000000000000000W000W000000000000000000000WW0W000W0W00000WWW00000W00000000000W0000W0000000000000
0W00000000000000WW00000000000W0W00000000000000000000000000WW0000W00000000000000000000W00000000000000
000000000000000000W0000W000000000000000000W0000000W00W0000W0W00000000000W00000000000000000000000000W
W0000W00000000W00000000000W000000000W00000000000W000000000000W0000000000W00000W000000000000000000000
000000000W000000000000000000000000000W00000000000W00W000000000000000000000000000000000000W000000W000
0W0000000W00000W000000000000W0000000000000W0000000000000WW000WW000000W00000WW00000000000W0000WW00000
00W0W00000W00000000000000W000000000000000000000W0000000000000W000W00000000000000000W00000000000W000W
0000000000W00000000000W000000W00W000000000W0000000000000W000000000W000W00000W000W000W0W00W0000000W00
000000000000000000000000000W000W0W00W0000000000000WW0W000000000000000000W0W00000W0000000000000000000
00000000000000WWW0000000000000000W000000000000000000000000W00000000000000000000000000000000000000W00
000WW000000W000000000000000W00000000W00W00000W00000000W0000W00000W0W000W00000WW00W0W0000000W0000W0W0
00000000000000W00000000000W00000000000000000000000000W000W0W00W000W00000000000W0000000W0000000000000
00000000000WW00000000000000000000000W0000W0000000000000000000000000000000W000000000000000000000W00W0
000000W0000000000W00000W000000000000000W000000W000000000W00W000WWWW0000W0000W000000000000WW00000W000
W0000000W000W000000000000000000000W0W00W0000000WWW00W0000000000000000000000000000000000W000000000000
000000000000000000000W000000W0W0W000000000WW00000000W0000000W000W00000000W000000000W00W0W000000W0W00
00W000000W0000000000000000000000000000W000W000000W00000000000000000000000W00000W00W0000W000000000000
0000000000WWW000000W00W00000W000W00000000000000000000000W0000000000000000000000W00000000000000000000
0000000W00000W000W000000W0000000000W0000000000000000000000W0000000000000W0000W0W00000W00W00000000000
00000000000000000000000000W0000000000W000000000000000000000000000000W0000000000000000W00000000000000
0000000000000W00000000000000W000000000000000W00W0000W000000000000W0000000000000000000W0000000WW000W0
000000000000000W0W000000W0000W00000000000WW0000000000000000000W000W000000000000W000000000W0000000000
000000000000000000000W00W00W000000W00000W0W0000W0W00000000000000000000000000000000000000000000000000
000000000W00000W000000000000000000W0000000000W0000000W00000000000000W0W000000W0000000000W00000000000
000000000000000000000000000000000W000000000000W00000000000000000W00000000W00000000000000000000000000
0000000000000000W0000000000000W0000000000W0000000000000W00000W000000W00W00000000000000000W0000000000
0W0000000000000000000000000000000000000000W0000000W00000000000W00000000W0W0W000000000000000000000000
000000W00W00000000000000000W000000W0000000000000000WW0000W00W000000000000W000000W00000000000000W0000
0000000000000000000000000000000W0000000W00W000000000W0000000000000000000000000000W00W00000000000W0W0
00000W00000W000000000000W0W00W00000W0W0W00000000000000000000W0W0000000W00000000W0000000W0000WW000000
000000000000000000000000W0000000000000W000000W000000000000000000W000000000000000W0W000000W000W000000
000000000000000000000000W000000000000000000000000000000W000W0000000000000000000000000000000000000000
000000W0000000W000W000000000000000000000000W00000000WW00000000000000000000000W000000000WWW00000W00W0
000000000000WW000000000W0W0000000W0000000000000000000000000000000000W0000000W000000W00000WWW00000000
00000000000W00000000000000000000000000W000000000000000000000000W000000000000000000000000000000000W00
0000000000W0W0W0000000000W000000000W00W0000W000000W0000W000W00000000000000000000000000000W0000000000
0000000000W000000W0000000000000000000000W000000W00000000W00WW000000000000000000000000000000W000W0000
0000000W0WW00W0000000000000000000000000W0000000000W0000000000W0W000000000000000000W00000000000000000
000000W000000000000000000000000000000000000000000000000000000000000000000000000W000W0000000W0W000000
0000000000000000000000W00W0W00000W00000000000W0000000000000W000000W00000000000000WW000000W0W00000000
0W00W00W00000000000000000W000000000000000000000000000000000000000000W0000W0000000000W000000000000000
W00000000000000000000000W0W00000000000W00W00W000000000000WW00000000000W00000000000W00000000000000W00
00W000W000000000000000000000000000W000000000000000WW00W0W000000000000000000000000000000000WW0000000W
000000000000000000000000000000W0000000000WW00000W000000000000000000000000000000000000W0W000000000000
000000000000W000000000W0000000000000000000W0W0000W000000000000000W0000W0W0W0000000000000W000000W0000
00000W000000000W00000W000W0000W00W00000000000000000000000000000W00000W00000000W00000W00000000000W000
W0000000000WW0W0000000000000000000000000000000W00000000000000000000000000W00000000000000000W00000000
00W0000000000000W0000000W0W00W00000W00000000000000000000W000000WW00WW000000W000W0000000000W000000000
0000000W0000W0000W00000000000000000000000W00W00000000W000000000000000000000W00000000000000WW00W0W000
0000000000000000000000000W0000000000000000000000000W00000000000W000W00W000000W0000000000W00000000000
0W0W00W000000000000W000W000000W0W0000000W000000000000000000000W0000000000000000W000000000000W0W00000
00000000000000000000000000W000000W0W00000000000000W000W00W000000000000000000000000000000000000W0000W
00W0000000000000W0000000000WWW00000W000000000000W00000000000000000000000000W000000000000000000000000
0000000000000000000000000W00W000W00W0W00000000W00000000W000000000W0000000000000000W000000W00W0000000
W00000000000000000000000000000W000WWW000000000000W000000W0W000000WW0W000000000000000000W000000000W00
000000000000000000000000000000W00000000000000000000000000W00000000000W00000000000000W000000000000000
0W00000000W00000000000000000000000000000000W00000W00000000000W00000W000W0000000000W000000000000000W0
00000000W00000000000000000000000W0000W000W000000000000000000000000W0W000000WW00000000000W00000000000
0W00000000000000000000000000000W0000W0000000000000W00000000000000000000000000W000000000WW00000000000
000000000W0000000000000000000W0000000W0000W000000W0000000000000000W00000000000000000000000000W000000
W000000W00000000000W000000WW0000000000000W0000000000W000W0000000000000000000000000000W000000WWW0000W
0000000000000W00000000000W00W000W00W0000000W00000000000W000000WW0000000W0000000WW0W00000000000000000
000W0000W0000000W000000000000WW00000000000000000000W000000000000W000000W0000000000000000000000000000
0000W0W00W0000W000000000000000000000000W000000W00000000000W00000WW0W0000000000W0000000W0000000000000
0000000000000000000000WW000000WW0W0000000000W000000W0000W000W000W0000W0000000000000000000000W0000000
000000000000000000000000000000W0000000000000000000000000000000000W0W000W000W00000000000W0W0000W00000
00000000000000000000WW0W00000000W0W000000000000000000000000000000W000000W0W00000W00000000000W0000000
000000000W000W00W00000000000000000W0000WW00000000000000000000000000000000W0000000000000W00W000W00000
000000W00000000000000000000WW0W00000000000W00000000000000000W00000000000000W0000W00000000000000W0000
0W00W00W0W00000W00W00000000000000W00000000000000000W00000000000000000WW000WW00W00000000000W000000000
0W000000000000000000000000000000000000000000000000000000000WW0000000000000000W0WW0000000000000W00000
W0W0000W000000000000000000000000000000000000000000000000000W0000WW00000000000000000WW000000W00000W00
W000000000000000W00000000000000000000W0000000000000000000000000000000W0000000W0W00000000000000000WW0
0W00000000000W00000000000000W000000W000000000W0000000000000000000W000W0000000000000000W0W0000000W00W
00000000000000000000W00000000W00000000000W000000000000WWWW0W00000000000000000000000000WW0000W0000000
00000000000000000000000W0000000000000000W00000000W0000000000000000000000000000000000000W000000000000
0000000000000000W000000000000000000W0000000000000W00000W0W00000000000000000WW000W000000000000000W000
00000000000W00W000000000000000W0000000WW00W00000000W00W00000000W000000000000000000000000000W00000000
000000W0W00000W0000000000000000000000000000000000000000000000000W0000000000000000W00000W000W00000W00
000000W00000000000000000000W00W00W000000000W0WW0W000000000000W00000000000000000000000W00000000000WW0
0000000W000W000000000000000W000000000000000W00000000000000000000W00000W000000000000W0000000000000000
0W0W00000000000000000W0W000000000000W0000W000W000W000000000000W0000000000000000000000000W0000000000W
0000000000000000000000000WW000W000000000W00W00W0000W000000W0000000000000000W0000000W0000000000W00000
0W000W0000000W00W00000000000000000000W000000000000W00000000000000000000000W000000000000000000W000000
0W0000W000000000000000000000000000000000W00W00000000000W0000W0000000000000000000000W00W000W000W000W0
000000000W00000000W00000000W00000W0W0W0W0000W0000W0000W0W000000000000000000W00000W000W00000W0000W000
000000000000000000000000000000000000000000000000000W000000000000000000000000000000000000W00000000000
0000000000000000000000000WW0000000000000W0WW000000000W00000000000W00000000W00000000000W0000000000000
00000000000000000W0000WW00000000000000000000000000000W00W00000000000W0000WWW000000W0W000000000000000
000W000000000W000W0WW000000000000000000000000000000000000000000000000000000000000W00000000W00W000000
0000W00000000000000000000000000W0W000000000000WWW0000000000000000000000W0000000000W0000000W00000000G